####################
# # #    #   #  #  #
#   ####   # # ### #
# # #    #  #   #  #
# #########   # # ##
# # # #   ### ##   #
# #   ### #   #  ###
# # # #   # #   #  #
#   #   #  ### ## ##
# # ######  #  #   #
#   # #   # # ## # #
# # #   #   #  #   #
# # ####### ## ### #
# ### #   ###      #
# #   ### #   ## ###
# # # #   # #      #
#  ##   # # # #### #
##   # #   ## #    #
#  #   # #    # ## #
####################